1111111111111111111111111111111111
1E000000000X000C00000C000X00000001
111001010010X000101001000X00010101
1010010010101010001001000000010101
1P0000000C00C000000X00X00000X001C1
1111111111111111111111111111111111