1111111111111111111111111111111111111111111
1P00000000000000000000000000000000000000001
1111101111111111111111111111111111111011111
1000000000000000000000000000000000000000011
1111111111011111111111111111111111111111111
1000000001010000000000000000000000000000011
1011111111010111111111111111111111110111111
1010000001010100000000000000000000000001011
1010111111010111111111111111111011111111011
1010000001010100000000000000000000000000011
1010111111010111111110111111111111111111011
1010000001010100000000000000000000000001011
1010111111010111111111111111111011111111011
1010000001010100000000000000000000000000011
1010111111010111101111111111111111111111111
1010000001010100000000000000000000000000011
1011111111010111101111111111111111111111011
1000000000000100000000000000000000000001C01
1111111111011111111111111111111111111111111
1000000001010000000000000000000000000000011
1011111111010111111111111111111111111111011
1010000001010100000000000000000000000000011
1010111111010111111111111110111111111111111
1010000001010100000000000000000000000000011
1010111111010110111111111111111111111111011
1010000001010100000000000000000000000000011
1010111111010111111111111111111111111111011
1010000001010000000000000000000000000001011
1011111111010111111111111111111111111111011
10000000000000000000010000000000000000000E1
1111111111111111111111111111111111111111111
